#######################################
# Syntax Coloring Map for M24SR64-Y
#######################################

#######################################
# Datatypes (KEYWORD1)
#######################################

Component	KEYWORD1
EmptyRecord	KEYWORD1
M24SR	KEYWORD1
Message	KEYWORD1
NDefNfcTag	KEYWORD1
NDefNfcTagM24SR	KEYWORD1
Nfc	KEYWORD1
Record	KEYWORD1
RecordAAR	KEYWORD1
RecordGeo	KEYWORD1
RecordHeader	KEYWORD1
RecordMail	KEYWORD1
RecordMimeType	KEYWORD1
RecordSMS	KEYWORD1
RecordText	KEYWORD1
RecordURI	KEYWORD1
RecordVCard	KEYWORD1
RecordWifiConf	KEYWORD1

#######################################
# Methods and Functions (KEYWORD2)
#######################################

ChangeAccessStateCallback	KEYWORD2
ChangePasswordRequestStatusCallback	KEYWORD2
CloseSessionCallBack	KEYWORD2
ManageGPOCallback	KEYWORD2
NDefNfcTag	KEYWORD2
OpenSessionCallBack	KEYWORD2
ReadByteCallback	KEYWORD2
ReadIDCallback	KEYWORD2
RecordURI	KEYWORD2
RemoveAllPasswordCallback	KEYWORD2
WriteByteCallback	KEYWORD2
add_record	KEYWORD2
add_records	KEYWORD2
bool	KEYWORD2
change_access_state	KEYWORD2
change_reference_data	KEYWORD2
close_session	KEYWORD2
copy_mime_data	KEYWORD2
delete_mime_data	KEYWORD2
disable_permanent_state	KEYWORD2
disable_verification_requirement	KEYWORD2
enable_permanent_state	KEYWORD2
end	KEYWORD2
erase	KEYWORD2
find	KEYWORD2
get_CF	KEYWORD2
get_FNT	KEYWORD2
get_IL	KEYWORD2
get_MB	KEYWORD2
get_ME	KEYWORD2
get_N_records	KEYWORD2
get_SR	KEYWORD2
get_auth_type	KEYWORD2
get_byte_length	KEYWORD2
get_content	KEYWORD2
get_encoding	KEYWORD2
get_encryption	KEYWORD2
get_header	KEYWORD2
get_id_length	KEYWORD2
get_language	KEYWORD2
get_messagge	KEYWORD2
get_mime_data	KEYWORD2
get_mime_data_lenght	KEYWORD2
get_mime_type	KEYWORD2
get_network_key	KEYWORD2
get_network_ssid	KEYWORD2
get_number	KEYWORD2
get_package	KEYWORD2
get_payload_length	KEYWORD2
get_record_length	KEYWORD2
get_text	KEYWORD2
get_type	KEYWORD2
get_type_length	KEYWORD2
get_uri_id	KEYWORD2
get_uri_type	KEYWORD2
headerFlags	KEYWORD2
if	KEYWORD2
init	KEYWORD2
insert	KEYWORD2
instance	KEYWORD2
is_first_record	KEYWORD2
is_last_record	KEYWORD2
is_middle_record	KEYWORD2
is_session_open	KEYWORD2
load_header	KEYWORD2
mBody	KEYWORD2
mBuffer	KEYWORD2
mByteRead	KEYWORD2
mByteToWrite	KEYWORD2
mByteWrote	KEYWORD2
mCallback	KEYWORD2
mCallbackParam	KEYWORD2
mCloseSessionCallback	KEYWORD2
mDevice	KEYWORD2
mGpoConfig	KEYWORD2
mMaxReadBytes	KEYWORD2
mNByteToRead	KEYWORD2
mNByteToWrite	KEYWORD2
mNewPwd	KEYWORD2
mOpenSessionCallback	KEYWORD2
mReadByteCallback	KEYWORD2
mSender	KEYWORD2
mWriteByteCallback	KEYWORD2
onFinishCommand	KEYWORD2
onVerified	KEYWORD2
on_change_reference_data	KEYWORD2
on_deselect	KEYWORD2
on_disable_all_password	KEYWORD2
on_disable_permanent_state	KEYWORD2
on_disable_read_only	KEYWORD2
on_disable_read_password	KEYWORD2
on_disable_verification_requirement	KEYWORD2
on_disable_write_only	KEYWORD2
on_disable_write_password	KEYWORD2
on_enable_permanent_state	KEYWORD2
on_enable_read_only	KEYWORD2
on_enable_read_password	KEYWORD2
on_enable_verification_requirement	KEYWORD2
on_enable_write_only	KEYWORD2
on_enable_write_password	KEYWORD2
on_manage_I2C_GPO	KEYWORD2
on_manage_RF_GPO	KEYWORD2
on_message_read	KEYWORD2
on_message_write	KEYWORD2
on_read_byte	KEYWORD2
on_read_id	KEYWORD2
on_selected_CC_file	KEYWORD2
on_selected_NDEF_file	KEYWORD2
on_selected_application	KEYWORD2
on_selected_system_file	KEYWORD2
on_session_close	KEYWORD2
on_session_open	KEYWORD2
on_updated_binary	KEYWORD2
on_verified	KEYWORD2
open_session	KEYWORD2
parse	KEYWORD2
parse_message	KEYWORD2
printf	KEYWORD2
push_back	KEYWORD2
read	KEYWORD2
readByte	KEYWORD2
read_binary	KEYWORD2
read_id	KEYWORD2
read_id_on	KEYWORD2
remove_and_delete_all_record	KEYWORD2
remove_record	KEYWORD2
select_system_file	KEYWORD2
set_CF	KEYWORD2
set_FNT	KEYWORD2
set_IL	KEYWORD2
set_MB	KEYWORD2
set_ME	KEYWORD2
set_SR	KEYWORD2
set_as_first_record	KEYWORD2
set_as_last_record	KEYWORD2
set_as_middle_record	KEYWORD2
set_auth_type	KEYWORD2
set_callback	KEYWORD2
set_content	KEYWORD2
set_encryption_type	KEYWORD2
set_id_length	KEYWORD2
set_message	KEYWORD2
set_mime_data_pointer	KEYWORD2
set_network_key	KEYWORD2
set_network_ssid	KEYWORD2
set_new_GPO_config	KEYWORD2
set_number	KEYWORD2
set_package	KEYWORD2
set_payload_length	KEYWORD2
set_task	KEYWORD2
set_type_length	KEYWORD2
size	KEYWORD2
store_removeing_prefix	KEYWORD2
update_binary	KEYWORD2
update_content_and_header	KEYWORD2
update_content_info_string	KEYWORD2
update_mime_data	KEYWORD2
update_playload_length	KEYWORD2
verify	KEYWORD2
void	KEYWORD2
write	KEYWORD2
writeByte	KEYWORD2
write_header	KEYWORD2
writeTxt	KEYWORD2
readTxt	KEYWORD2
writeUri	KEYWORD2
readUri	KEYWORD2
writeAAR	KEYWORD2
readAAR	KEYWORD2
writeURIMail	KEYWORD2
readURIMail	KEYWORD2
writeSMS	KEYWORD2
readSMS	KEYWORD2
writeMime	KEYWORD2
readMime	KEYWORD2

#######################################
# Constants (LITERAL1)
#######################################

UB_STATUS_OFFSET	LITERAL1
LB_STATUS_OFFSET	LITERAL1
I_AM_M24SR	LITERAL1
I_AM_M24SR_AUTOMOTIVE	LITERAL1
M24SR_NBBYTE_INVALID	LITERAL1
SYSTEM_FILE_ID_BYTES	LITERAL1
CC_FILE_ID_BYTES	LITERAL1
NDEF_FILE_ID	LITERAL1
READ_PWD	LITERAL1
WRITE_PWD	LITERAL1
I2C_PWD	LITERAL1
M24SR_OPENSESSION_COMMAND	LITERAL1
M24SR_KILLSESSION_COMMAND	LITERAL1
C_APDU_CLA_DEFAULT	LITERAL1
C_APDU_CLA_ST	LITERAL1
C_APDU_SELECT_FILE	LITERAL1
C_APDU_GET_RESPONCE	LITERAL1
C_APDU_STATUS	LITERAL1
C_APDU_UPDATE_BINARY	LITERAL1
C_APDU_READ_BINARY	LITERAL1
C_APDU_WRITE_BINARY	LITERAL1
C_APDU_UPDATE_RECORD	LITERAL1
C_APDU_READ_RECORD	LITERAL1
C_APDU_VERIFY	LITERAL1
C_APDU_CHANGE	LITERAL1
C_APDU_DISABLE	LITERAL1
C_APDU_ENABLE	LITERAL1
C_APDU_INTERRUPT	LITERAL1
M24SR_STATUS_NBBYTE	LITERAL1
M24SR_CRC_NBBYTE	LITERAL1
M24SR_STATUSRESPONSE_NBBYTE	LITERAL1
M24SR_DESELECTREQUEST_COMMAND	LITERAL1
M24SR_DESELECTRESPONSE_NBBYTE	LITERAL1
M24SR_WATINGTIMEEXTRESPONSE_NBBYTE	LITERAL1
M24SR_PASSWORD_NBBYTE	LITERAL1
M24SR_SELECTAPPLICATION_COMMAND	LITERAL1
M24SR_CMDSTRUCT_SELECTAPPLICATION	LITERAL1
M24SR_CMDSTRUCT_SELECTCCFILE	LITERAL1
M24SR_CMDSTRUCT_SELECTNDEFFILE	LITERAL1
M24SR_CMDSTRUCT_READBINARY	LITERAL1
M24SR_CMDSTRUCT_UPDATEBINARY	LITERAL1
M24SR_CMDSTRUCT_VERIFYBINARYWOPWD	LITERAL1
M24SR_CMDSTRUCT_VERIFYBINARYWITHPWD	LITERAL1
M24SR_CMDSTRUCT_CHANGEREFDATA	LITERAL1
M24SR_CMDSTRUCT_ENABLEVERIFREQ	LITERAL1
M24SR_CMDSTRUCT_DISABLEVERIFREQ	LITERAL1
M24SR_CMDSTRUCT_SENDINTERRUPT	LITERAL1
M24SR_CMDSTRUCT_GPOSTATE	LITERAL1
M24SR_PCB_NEEDED	LITERAL1
M24SR_CLA_NEEDED	LITERAL1
M24SR_INS_NEEDED	LITERAL1
M24SR_P1_NEEDED	LITERAL1
M24SR_P2_NEEDED	LITERAL1
M24SR_LC_NEEDED	LITERAL1
M24SR_DATA_NEEDED	LITERAL1
M24SR_LE_NEEDED	LITERAL1
M24SR_CRC_NEEDED	LITERAL1
M24SR_DID_NEEDED	LITERAL1
M24SR_OFFSET_PCB	LITERAL1
M24SR_OFFSET_CLASS	LITERAL1
M24SR_OFFSET_INS	LITERAL1
M24SR_OFFSET_P1	LITERAL1
M24SR_MASK_BLOCK	LITERAL1
M24SR_MASK_IBLOCK	LITERAL1
M24SR_MASK_RBLOCK	LITERAL1
M24SR_MASK_SBLOCK	LITERAL1
